++++++++++++++++++++++++++++++++
+a1   A0                   a  A+
+  +++++++++++++++++++++++++++++
++++++++++++++++++++++++++++++++
++++++++++++++++++   +++++++++++
+2                Bb         Bb+
++++++++++++++++++++++++++++++++
