++++++++++++++++++++++++++++++++
+0                           Bb+
++++++++++++++++++++++++++++++++
+bB                           1+
++++++++++++++++++++++++++++++++