+++++++++++++++++++
+                 +
+                 +
+                 +
+          A      +
+      A A        +
+ A     A0A       +
+  a     A        +
+                 +
+  A             A+
+      A          +
+                 +
+                 +
+                 +
+++++++++++++++++++

