green: 2,C,E
red: 1,B,F
blue: 0,A,D
+++++++++++++++++++++++++++++++++++
+1              ABC              0+
+                                 +
+             D  E  F             +
+                2                +
+             E  F  D             +
+                                 +
+             F  D  E             +
+                                 +
+             D  E  F             +
+                                 +
+++++++++++++++++D+++++++++++++++++
+++++++++++++++++E+++++++++++++++++
+++++++++++++++++F+++++++++++++++++
+++++++++++++++++a+++++++++++++++++
+++++++++++++++++b+++++++++++++++++
+++++++++++++++++c+++++++++++++++++
+++++++++++++++++++++++++++++++++++
+++++++++++++++++++++++++++++++++++
