red: 0,A,D
green: 1,C,B
+++++++++++++
+a+        c+
+ + +++++++++
+ + +0  AB  +
+ + +   CD  +
+ + +      1+
+ + +       +
+           +
++++++      +
++++++ ++++ +
++++++ ++++ +
++++++ ++++ +
+b     ++++d+
+++++++++++++
