 ++++++++++
 +DDDDDIMR+
 +DDDDDDDO+
 +DDDDDDDN+
 +DDDDDDDD+
 +DDDDDDDD+
 +DDDDDDDD+
 +DDDDDDDD+
++ DDDDDDD+
+0 ++++++++
++ din mor+
 ++++++++++
