++++++++++++
+aKLJMIHN+h+
+b+      +i+
+c++++++++j+
+d   0    k+
+e++++++++l+
+f+      +m+
+g+AGBFCEDn+
++++++++++++
