blue: 0,1,D,B
red: 2,3,C,A,E
      +++   +++++++ +++++++     +++      +++      +++
     +  D+    +a+   +          +   +     +e +    +  +
    +  +  +   +B+   + ++      +  + 1+    +   +  +   +
   + A+++  +  +E+   +        + c+++  +   +    ++   2+
  +3 +   +  + + +   +++++++ +  +   +  +  +  +  C +  +
 +  +++++++  ++ ++++++++++++  +++++++  +++  ++  ++  +
+          0         d                             b+
+++++++++++++++++++++++++++++++++++++++++++++++++++++
