red: 0,A,B
blue: 1,C,D
green: 2,E,F
magenta: 3,G,H
+++++++++  +++++++++
+a  0  H+  +D  2  e+
+c     F+  +B     g+
+       ++++       +
+                  +
+       ++++       +
+d     E+  +A     h+
+b  1  G+  +C  3  f+
+++++++++  +++++++++
