      +++   +++++++ +++++++     +++      +++      +++
     +  D+    +a+   +          +   +     +e +    +  +
    +  +  +   +B+   + ++      +  +  +    +   +  +   +
   + A+++  +  +E+   +        + c+++  +   +    ++    +
  +  +   +  + + +   +++++++ +  +   +  +  +  +  C +  +
 +  +++++++  ++ ++++++++++++  +++++++  +++  ++  ++  +
+          0         d                             b+
+++++++++++++++++++++++++++++++++++++++++++++++++++++
