 ++++++++++
 +DDDDDIMR+
 +DDDDDDDO+
 +DDDDDDDN+
 +DDDDDDDD+
 +DDDDDDDD+
 +DDDDDDDD+
 +DDDDDDDD+
++  DDDDDD+
+0 ++++++++
++  in mor+
 ++++++++++
