+++++++++++++++++++++++++++++++++++++++++++++++++++++++++++++++++++++
+   +     +    0    +         +   +           +   +   +   +        a+
+ + + + + + +++++ + + +++++ + + + + +++++++++ + + + + + + + +++++++ +
+ + + + +   +   + +   +   + + + +   +   +   + + + + + + +     +     +
+ + + + + +++ + + +++++ + + + + +++++ + + + + + + + + + +++++ + +++ +
+     + + +   + +       +   +   +     +   + + + + + +   +   +   +   +
+++++++ + + + + +++++++++++++++++ +++++++++ + + + + +++++ + +++++ +++
+     +   + + +           +   +   +           + + + +     +     +   +
+ +++ + +++ + +++ +++ +++ + + + + + +++++ +++++ + + + +++++++++ +++ +
+ +   +     +   + +   +     + + + + +   + +     + + +         + +   +
+ + +++++++++++ + + +++ + + + + + + + + + + +++++ + +++++++++ + + + +
+   +         +   + +   + +   + + +   +   +     + +   +         + + +
+ +++ +++++++ +++ + + + + +++++ + +++++++++++++ + +++ + +++++++++ + +
+ +   +     +   + +   + + +     +     +       +     + + +       + + +
+ + +++ +++ +++ + + +++ + + +++ +++++ + +++++ +++ + + + + +++ + + + +
+ +     +     + +   +     +     +   + + +   +   + +   + +   + +   + +
+ +++++++ + + + +++++ +++++++ +++ + + + + + +++ + + +++ + + + +++ + +
+     +   + +         +     +     +   +   +   +   + +   + + +   + + +
+++++ + +++ +++ +++++++ +++ +++++++++++++++++ + +++ + + + + + + + + +
+   + + +     +   +   +   +   +     +   +   + + +     + +   + + + + +
+ + + + + +++ +++ + + +++ +++ + +++ + + + + + + + + +++ +++++ + + + +
+ +   +   +       + + +     + +   + + +   +   +   + +       + +   + +
+ +++++++++ +++++ + + + +++ + +++ + + +++++++++++ + + +++++ + +++++ +
+ +   +     +     +   + +   + +     +           +   + +   +     +   +
+ + + + +++++ + +++ +++ + +++ + +++++++++++++++ +++++ + + +++++ + +++
+ + + +       + +   +   +     + +       +     +         +     +     +
+ + + +++++++ + + +++ +++++++++ + +++ + + + + + +++++ +++++ + +++++ +
+   +         + +     +       + +   + + + + + + +   +     + + +     +
+++++ +++++++++ +++++ + +++++ + +++ + + + + + + + + +++++ + + + +++ +
+   + +   +     +   + + +   +   +   + + +   +     +     + +   + +   +
+ + + + + + +++ + + + + + + + +++ +++ + +++++++++++ +++ + +++++ + +++
+ +     +   +   + +   +   + + +     + +       +   + +   + +   +     +
+ +++++++++++ +++ +++++++++ + + + + + +++++++ + + + + +++ + + +++++ +
+     +     + +   +     +   + + + +   +   +   + +   + +   + +     + +
+++++ + +++ + + + + +++ + + + + + +++++ + + + + + +++ + +++ +++++ + +
+   + + +   +   + + +   + + + +   +     +   + + + +   + +     +   + +
+ + + + + + +++++ + + + + + + +++ + + +++++ + + + + +++ + + + + + + +
+ +   + + +       +   + + +   +   + + +   + +   + + +     + +   + + +
+ +++++ + +++ +++++ +++ + +++++ +++ + + + + +++++ + + +++++ +++++ + +
+     + +   + +     +   +         +     +   +     + +       +     + +
+++ + + + + + + +++++ +++++++++++ +++++++++ + +++++ + +++++++ +++ + +
+   + + + +   + +   +   +       +   +     + +   +     +       +   + +
+ + + + + +++++ + + +++ + +++++ +++ + +++ + +++ + +++++ +++++++ +++ +
+ + + + +     +   +   + + +         +   + +   +   +     +     + +   +
+ + + + + +++ + +++ + + + + +++++++++++ + +++ + +++ +++ + +++ + + + +
+   + +   +   +   + + +   +           + +   + +   +   + + +   +   + +
+++++ +++++ + +++ + + +++++++++++++++ + +++ + +++ +++ + + + + +++++ +
+   +       +   + +                 + +     +   +   + + + + + +   + +
+ + +++++++++++ + +++++++ +++++++++ + +++ +++ + +++ + + + + + + + + +
+ +         +   +   +   +     +   + +         +     + +   + + + +   +
+ +++++++ + + +++++ + + +++++ + + + +++++++++++++++ + + +++ + + +++++
+ +     + + + +     + +     +   + +     +       +   + + +   + + +   +
+ + +++ + + + + +++ + +++++ +++++ +++++ + + +++ + +++ + + +++ + + + +
+ +   + + + + +     +   +       +     +   + +   + +   +     + +   + +
+ +++ + + + + +++++++++ + +++++ +++++ +++++ + + + + + +++ + + +++++ +
+ +     +   + +       +   +   +       +       +   + + +   + +     + +
+ + + +++++++ + +++++ + +++ + + +++++++ +++++++++++ + + +++ +++++ + +
+ + + +       + +   + +     +   +     +     +   +   +   +         + +
+ + + + +++ + + + + + +++++++ +++ + + +++++ + + + +++++++ + +++++++ +
+ + +   +   +     + +       + +   + + +   + + +   +   +   + +     + +
+ + + +++ + +++++++ +++++++ + + + + + + + + + +++++ + + + + + +++ + +
+   + +   + +     +     +   +   + + +   +   +     + + + + + + +   + +
+ +++ + + + + +++ +++++ + + +++++ + + +++ +++++++ + + + + + + + + + +
+ +   + + +       +   +   +   +   + + +   +       + + +   +   + + + +
+ + + + + +++++++++ + + +++++ + +++ + + +++ +++++ + + +++++++++ + + +
+   + + +   +     + + +   +   + +   +   +   +   + + + +       +   + +
+ +++ + +++ + +++ + + +++ + +++ + +++++++ +++ + + + + + + +++ +++++ +
+A    +     +       +     +     +             +     +   +           +
+++++++++++++++++++++++++++++++++++++++++++++++++++++++++++++++++++++
