                              +++
                              +0+
+++++++++++++++++++++++++++++++A+++++++++++++++++++++++++++++++++
+                                                               +
+ +++++++++++++++++++++++++++++++++++++++++++++++++++++++++++++ +
+ +                                                           + +
+ + +++++++++++++++++++++++++++A+++++++++++++++++++++++++++++ + +
+ + +                                                       + + +
+ + + +++++++++++++++++++++++++++++++++++++++++++++++++++++ + + +
+ + + +                                                   + + + +
+ + + + +++++++++++++++++++++++++++++++++++++++++++++++++ + + + +
+ + + + +              B                               b+ + + + +
+ + + + + ++++++++ +++ ++++++++++++++++++++++++++++++++ + + + + +
+ + + + + ++++++++ +++ ++++++++++++++++++++++++++++++++ + + + + +
+ + + + +        +    b          B+   E +               + + + + +
+ + + + ++++++++ ++++++++++++++++++ e   +  ++++++++++DB + + + + +
+a+a+a+a  B   b  +   +++                +  +   +    +++++ + + + +
+ + + + +++ ++++++ +   +     ++++++++++++  + + + +  +b+ + + + + +
+ + + + + +++      +d  +                +  + + + +  +   + + + + +
+ + + + + +++ +++++++++++++++++++++++++ +  + + + +  +++ + + + + +
+ + + + +                                    +   +      + + + + +
+ + + + +++++++++++++++++++++++++++++++++++++++++++++++++ + + + +
+ + + +                                                   + + + +
+ + + +++++++++++++++++++++++++A+++++++++++++++++++++++++++ + + +
+ + +                                                       + + +
+ + +++++++++++++++++++++++++++++++++++++++++++++++++++++++++ + +
+ +                                                           + +
+ +++++++++++++++++++++++++++++A+++++++++++++++++++++++++++++++ +
+                                                               +
+++++++++++++++++++++++++++++++++++++++++++++++++++++++++++++++++
