++++++++++++++
+a+      0+AF+
+b+       +BE+
+c+       +CD+
+zX       +DC+
+d+       +EB+
+e+       +FA+
+f+       xZZ+
++++++++++++++
