red: 1,D
green: 0,V 
yellow: 2,E 
++++++++++++
+       1+d+
+ ++++++++D+
+ ++++++++ +
+   2Ee    +
+ ++++++ + +
+ ++++++ + +
+V++++++++ +
+v+0       +
++++++++++++
