red: 8,D
green: 9,V 
yellow: 7,E 
++++++++++++
+       8+d+
+ ++++++++D+
+ ++++++++ +
+   7Ee    +
+ ++++++ + +
+ ++++++ + +
+V++++++++ +
+v+9       +
++++++++++++
