red: 0,D
green: 1,V 
yellow: 2,E 
++++++++++++
+       0+d+
+ ++++++++D+
+ ++++++++ +
+   2Ee    +
+ ++++++++ +
+ ++++++++ +
+V++++++++ +
+v+1       +
++++++++++++
