red: 1,A
green: 0,B
++++++++++++
+  1     +a+
+ ++++++++A+
+B  b      +
++++++++++ +
+0         +
++++++++++++
