red: 1,B
green: 0,A
++++++++++++
+  0     +a+
+ ++++++++A+
+     1    +
++++++++++ +
+          +
++++++++++++
