++++++++++++++++++++++++++++++++
+0                Bb         Bb+
++++++++++++++++++++++++++++++++
+                           bB1+
++++++++++++++++++++++++++++++++