red: 0,A
green: 1,B
+++++ +++++
+a  + +b  +
+   + +   +
+A0A+ +B1B+
+   + +   +
+  a+ +  b+
+++++ +++++